11111111111\n1E000001111\n1000C001C01
1C000001111
10000000001
1C000000P01
10000C00001
1C000000001
1C0000C0001
1C000000001
11111111111