1111111
1PCE111
10001C1
1111111